3
5 5
#S###
#...#
#.#.#
#....
###G#
5 7
#S#####
#.....#
#...#.#
G...#.#
#######
8 21
#S###################
#............########
#########.##.########
#####.....##.########
##....######.########
##.####...##.....####
##......#.######.####
#########.......G####