2
5 5
#S###
#...#
#.#.#
#....
###G#
5 7
#S#####
#.....#
#...#.#
G...#.#
#######